1111111
11E0011
1P00001
1111111
