111111111111111111111111111111
100001C00000000101000001001001
1000000P00000C0001C110CC000111
1011100100010001001C1001000001
10100E00000110C00C000100000C01
111111111111111111111111111111
