1111111111
1P00C00001
1CC0000C01
1000000001
1C00000001
1000000CE1
100C000001
1000000C01
10000C0C01
1111111111
