1111111111
10C0CCC001
1000000C01
1C0C000EC1
1000000C01
1000000001
1C00000001
10P0000001
100C000CC1
1111111111
