111111111111
1E00000000P1
10000P000001
1C0000000001
111111111111